P P P P F F F F P P P P P P P P P M M M M P P P P P P P P W W W W
P P P F F F F F F F P P P P P P M M M M M M P P P P P P W W W W W
P P F F F F F F P P P P P P M M M M M M M M P P P P P W W W W W W
P P F F P P P P P P P P P M M M M M M M M M M P P P W W W W W W W
P P P P P P P P P P P P R M M M M M M M M M M M P P W W W W W W W
P P P P P V P P P P P R R P M M M M M M M M M P P P W W W W W W W
P P P P P P P P P P R R P P P P M M M M M P P P P P W W W W W W W
P P P P P P F F F R R P P P P P P P P P P P P P P P W W W W W W W
M M P P P P F F R R P P P P P P P P P P P P P P P P P P W W W W W
M M M P P P P R R P P P P P P P P P P P P P P P P P P P P P P W W
P M M M M M R R P P P F F F F P P P P P P P P P P M M P P P P P P
P P M M M R R P P P F F F F F F P P P P P P P P M M M M P P P P P
P P P M M R P P P F F F F F F P P P P P P P P P M M M M P P P P P
P P P P M R R P P P P P F F P P P P P P P P P P P M P P P P P P P
P P P P P R R P P P P X P P P P P P P P P P P P P P P P P P P P P
P P P P P P R R R R R R R R R R R R R R W W W W W W W W W W W W W
P P P P P P P P P P P P P P P R R R R W W W W W W W W W W W W W W
P P P P P P P P P P P P P P P R R R P W W W W W W X W W W W W W W
P P P P P P P P P P P P P P R R R P P W W W W W W W W W W W W W W
P P P P P P P P P P P P P P P R R P P P W W W W W W W W W W W W W
P P P P P P P P M M P P P P P P P P P P P P P W W W W W W W W W W
P P P P P P P P M M M P P P P P P P P P P P W W W W W W W W W W W
P P P P P P P P P M M M M P P P P P P P P W W W W W W W W W W W W