P P P P Q Q Q Q P P P P P P P P
P P P Q Q Q Q Q Q Q P P P P P P
P P Q Q Q Q Q Q P P P P P P M M
P P Q Q P P P P P P P P P M M M
P P P P P P P P P P P P Q M M M
P P P P P Q P P P P P Q Q P M M
P P P P P P P P P P Q Q P P P P
P P P P P P Q Q Q Q Q P P P P P
M M P P P P Q Q Q Q P P P P P P
M M M P P P P Q Q P P P P P P P
P M M M M M Q Q P P P Q Q Q Q P
P P M M M Q Q P P P Q Q Q Q Q Q