P P P P F F F F P P P P P P P P
P P P F F F F F F F P P P P P P
P P F F F F F F P P P P P P M M
P P F F P P P P P P P P P M M M
P P P P P P P P P P P P R M M M
P P P P P V P P P P P R R P M M
P P P P P P P P P P R R P P P P
P P P P P P F F F R R P P P P P
M M P P P P F F R R P P P P P P
M M M P P P P R R P P P P P P P
P M M M M M R R P P P F F F F P
P P M M M R R P P P F F F F F F