P M M M M P P P P P P P P W W W W
M M M M M M P P P P P P W W W W W
M M M M M M P P P P P W W W W W W
M M M M M M M P P P W W W W W W W
M M M M M M M M P P W W W W W W W
M M M M M M M P P P W W W W W W W
M M M M M P P P P P W W W W W W W
P P P P P P P P P P W W W W W W W
P P P P P P P P P P P P W W W W W
P P P P P P P P P P P P P P P W W
P P P P P P P P P M M P P P P P P
P P P P P P P P M M M M P P P P P