P M M M M P P P P P P P P O O O O
M M M M M M P P P P P P O O O O O
M M M M M M P P P P P O O O O O O
M M M M M M M P P P O O O O O O O
M M M M M M M M P P O O O O O O O
M M M M M M M P P P O O O O O O O
M M M M M P P P P P O O O O O O O
P P P P P P P P V P O O O O O O O
P P P P P P P P P P P P O O O O O
P P P P P P P P P P P P P P P O O
P P P P P P P P P M M P P P P P P
P P P P P P P P M M M M P P P P P