P P P M M R P P P F F F F F F P
P P P P M R R P P P P P F F P P
P P P P P R R P P P P P P P P P
P P P P P P R R R R R R R R R R
P P P P P P P P P P P P P P P R
P P P P P P P P P P P P P P P R
P P P P P P P P P P P P P P R R
P P P P P P P P P P P P P P P R
P P P P P P P P M M P P P P P P
P P P P P P P P M M M P P P P P
P P P P P P P P P M M M M P P P
P P P P P P P P P M M M M P P P