P P P P P P P P M M M M P P P P P
P P P P P P P P P M P P P P P P P
P P P P P P P P P P P P P P P P P
R R R R O O O O O O O O O O O O O
R R R O O O O O O O O O O O O O O
R R P O O O O O O X O O O O O O O
R P P O O O O O O O O O O O O O O
R P P P O O O O O O O O O O O O O
P P P P P P P O O O O O O O O O O
P P P P P P O O O O O O O O O O O
P P P P P O O O O O O O O O O O O
P P P P O O O O O O O O O O O O O